
	NO  ./textures/boss.png	     
				

			SO 		./textures/fool.png
				
		WE 	   ./textures/noo.png

   EA   ./textures/orange-wood.png

   C 220,30,0

   	F 220,100,0


111111111111111111111111111111111111111111111111111111111
100000000000000000000000000000000000000000000000000000001
100000000000000000000000000000000000000000N00000000000001
100011111000011111000011110000000110000011100011100000001
110100000000110001100011001100001101100011010101100000001
110100000000110001100011001100011111100011001001100000001
100011111000011111000011110000110000110011000001100000001
100000000000000000000000000000000000000000000000000000001
100000000000000000000000000000000000000000000000000000001
100000000000000000000000000000000000000000000000000000001
111111111111111111111111111111111111111111111111111111111