

	NO  ./textures/boss.png	     
				

			SO 		./textures/fool.png
				
		WE 	   ./textures/noo.png

   EA   ./textures/orange-wood.png

   C 220,30,0

   	F 220,100,0
	

111111
1100011
110011	
111111	   