
				   


							     
  
			   
11111
1CPE1
11111