
	NO  ./textures/wall_wood_bush_3.png	     
				

			SO 		./textures/stone_grass.png









			
				
		WE 	   ./textures/goat_on_tree.png

   EA   ./textures/colorfull_stones.png


   C 		0,139,139

   	F 		245,245,220


      1111111111111111111111 11111111
     1111111111111111111111
  1111111111111111111111111111111
  1000001                    101
 11111111111111111111111111111111
 111001111111111111111111111111111111
 11110E0000000000000000000000000001111
 1111111000000000000000000000000000001
11111000000000000000001111111111111111
 11111111101111101111011      1  1
11    11111111111111111

