

	NO  ./textures/stone_grass.png	     
				

			SO 		./textures/purple_wall.png
				
		WE 	   ./textures/red_bricks_fence.png

   EA   ./textures/wolfengoat.png

   C 	100,149,237

   	F 90,0,44







   

	
111111111111111111111111111111111111111111111111111111111111111
1E0000000000000000000000000000000000000000000000000000000000001
100000000000000000000000000000000000000000000000000000000000001
111111111111111111111111111111111111111111111111111111111111111



			  