
NO     ./textures/tree.png
SO ./textures/purple_wall.png
WE ./textures/wolfengoat.png
EA 						./textures/stone_grass.png

F 60,69,68
C                        250,25,25


11111111
1000001
11111111
111111
111111          11        
11111111                                             1111
11  1111                                             101
1111111                               111111111111111111
11111
111
111
1111111    1111111
          1111
          1111     11111111111
                    10000W0001
                    1111111111     1111111
                                    1   11
                                    111111
1111
1001
1111
111
101
111