
	NO  ./textures/boss.png	     
				

			SO 		./textures/fool.png
				
		WE 	   ./textures/noo.png

   EA   ./textures/orange-wood.png

   C 220,30,0

   	F 220,100,0


11111111111111111111111
10000000000001000000001
10000000000000000000001
11011100001111000000001
11000000001111000000001
1111111100011100N000001
10000000000001000000001
10000000000001000000001
11011100001111000000001
10000000000000000000001
11111111111111111111111