
	NO  ./textures/colorfull_stones.png	     
				

			SO 	./textures/red_bricks_fence.png
				
		WE 	   ./textures/red_bricks_ivy.png

   EA   ./textures/stone_grass.png

   C 204,255,255

   	F 102,204,0


111111111111111111111111111
100000000000000000000000001
100000001110000001111100001
10000011011000E010001100001
100001100110000000011000001
100011111111100000110000001
100000000110000011000000001
100000000110000111111000001
100000000000000000000000001
111111111111111111111111111

