

	NO  ./textures/wall_wood_bush_3.png	     
				

			SO 		./textures/stone_grass.png
				
		WE 	   ./textures/red_bricks_fence.png

   EA   ./textures/redbricks_1.png

   C 180,200,0

   	F 	210,59,104

	
               111111
            1111111111111111111111111111111111
            1000000000000001000000000000000001
        111111010010100100111111101000000010101
        101001001010101000111   1100001010111111
        1E000000010010000011111110000000000000001 
       110000000010010000000000000000000111111111
        1111111111111111111111111111111111
              11111111
