
	NO  ./textures/redbricks_1.png	     
				

			SO 		./textures/purple_wall.png
				
		WE 	   ./textures/colorfull_stones.png

   EA   ./textures/wolfengoat.png

   C 	0,191,255

   	F 		128,0,128


11111111111111111111111111111111111111111111111111111
10000000000000000000000000000000000000000000000000001
100000000000000000000000000000000000000000N0000000001
10001111100001111100001111000000011000001110001110001
10010000000011000110001100110000011000001101010110001
10010000000011000110001100110001111110001100100110001
10001111100001111100001111000011000011001100000110001
10000000000000000000000000000000000000000000000000001
10000000000000000000000000000000000000000000000000001
10000000000000000000000000000000000000000000000000001
11111111111111111111111111111111111111111111111111111