
	NO  ./textures/boss.png	     
				

			SO 		./textures/fool.png
				
		WE 	   ./textures/noo.png

   EA   ./textures/orange-wood.png

   C 220,30,0

   	F 220,100,0


      1111111111111111111111 11111111
     1111111111111111111111
  1111111111111111111111111111111
  1N000001                    101
 1110011111111111111111111111111
 111001111111111111111111111111111
  11000000000000000000000000000001111
 1111111000000000000000000000000000001
11111000000000000000000111111111111111
 11111111101111101111011      1  1
11    111 111111111111