

	NO  ./textures/boss.png	     
				

			SO 		./textures/fool.png
				
		WE 	   ./textures/noo.png

   EA   ./textures/orange-wood.png

   C 220,30,0

   	F 220,100,0

	
               111111
            1111111111111111111111111111111111
            1000000000000001000000000000000001
        111111010010100100111111101000000010101
        101001001010101000111   1100001010111111
        1W000000010010000011111110000000000000001 
       110000000010010000000000000000000111111111
        1111111111111111111111111111111111
              11111111
			   
	      
		        