NO  ./textures/wall_wood_bush_3.png	     
				

			SO 		./textures/stone_grass.png
				
		WE 	   ./textures/red_bricks_fence.png

   EA   ./textures/redbricks_1.png

   C 180,200,0

   	F 	210,59,104


               1111111111111111111111111111111111111111111111111111111111111111
              111111100000000000000000000000000000000000000000N0000000001111111111111
        11111111111111111110001111100001111100001111000000011000001110001110001
           11111111010000000011000110001100110000110110001101010110001111111111111
         11111111010000000011000110001100110101011110001100100110001111111
         11111111111110001111100001111100001111000011000011001100000110001111111
           11111111010000000011000110001100110000110110001101010110001111111111111
         11111111010000000011000110001100110101011110001100100110001111111
         11111111111110001111100001111100001111000011000011001100000110001111111
           11111111010000000011000110001100110000110110001101010110001111111111111
         11111111010000000011000110001100110101011110001100100110001111111
         11111111111110001111100001111100001111000011000011001100000110001111111
           11111111010000000011000110001100110000110110001101010110001111111111111
         11111111010000000011000110001100110101011110001100100110001111111
         11111111111110001111100001111100001111000011000011001100000110001111111
            111111100000000000000000000000000000000000000000000000000001
          11111111111111111111111111111111111111111111111111111111111111111
